▨▨▨▨▨▨▨▨▨▨▨▨▨
▨☆○◎○◎○○○※▨V▨
▨○>○○▨▨▨▨▨▨○▨
▨◎○◎○◎※▨○○▨◎▨
▨○>○▨▨▨○○○▨○▨
▨◎▨◎○◎V○○※○○▨
▨○>○※○○▨▨▨▨▨▨
▨○▨▨▨○○○◎○○○▨
▨○○※○○▨▨○▨▨○▨
▨○▨○▨○○▨○○▨○▨
▨○>○○○▨▨▨▨▨○▨
▨○○○▨○※○○○○◎▨
▨※▨>○○▨○▨▨▨▨▨
▨○▨○○▨○○○○○V▨
▨○▨○▨▨○▨▨▨▨○▨
▨◎▨>○※○○○○○★▨
▨▨▨▨▨▨▨▨▨▨▨▨▨▨