▨▨▨▨▨▨▨▨
▨§▨☆▨○★▨
▨◎▨○▨○○▨
▨○○○Ⅲ○○▨
▨▨▨○▨▨▨▨
▨○◎○○○♥▨
▨A▨○▨▨▨▨
▨§▨○▨★○▨
▨◎▨○▨▨○▨
>○VⅢ○○○▨
▨▨▨▨▨▨▨▨