▨▨▨▨▨▨▨▨▨▨
▨◐V▨☆♥○○◎▨
▨▨○▨○○○○▨▨
▨▨○○※○◎▨▨▨
▨>○○○V○V▨▨
▨▨§▨>○○○◎▨
▨>○○○○▨▨▨▨
▨○○◎○▨▨▨▨▨
▨▨>○○⇔Ⅲ★▨▨
▨▨▨▨▨▨▨▨▨▨