▨▨▨▨▨▨▨▨▨▨▨▨▨
▨☆▨V▨○○○○○◎V▨
▨○○○○○○▨▨▨>○▨
▨▨▨○▨▨▨▨▨◎○○▨
▨○○○>○○○◎○○○▨
▨○▨▨▨▨▨▨※○○○▨
▨○○◐Ⅲ○○○○▨▨▨▨
▨▨▨▨▨○▨▨>○○○▨
▨○★◎○○○○◎○▨○▨
▨▨▨▨▨▨▨§▨▨▨○▨
▨◎○○○▨○○>○※○▨
▨▨○○▨○○▨○○▨○◎▨
▨▨○▨▨○○▨○▨▨▨▨
▨○○♥▨○▨▨○▨○○▨
▨○▨▨▨○○※○○○○▨
▨○○○⇔○○▨○○○◎▨
▨▨▨▨▨▨▨▨▨▨▨▨
