▨▨▨▨▨▨▨▨
▨★▨☆▨§▨▨
▨◎▨○▨○▨▨
▨○▨○▨○○▨
▨○▨○▨▨○▨
▨○Ⅲ○○○♥▨
▨▨▨▨▨▨▨▨