▨▨▨▨▨▨▨▨▨▨▨▨▨▨▨
▨▨▨▨>◎○○○A▨▨▨▨▨
▨▨▨▨▨▨▨▨※V▨▨▨▨▨
>☆○○○◎○○○○○○○★▨
▨▨▨▨▨▨▨▨▨○▨▨▨▨▨
▨▨▨▨>◎○○○※▨▨▨▨▨
▨▨▨▨▨▨▨▨▨▨▨▨▨▨▨