▨▨▨▨▨▨▨▨▨
▨◎◎ⅢⅢ★▨☆▨
▨◎V▨▨▨▨○▨
▨◎⇔◎◎◎◎◎▨
>◎§◎▨○○○▨
▨◎◎◎▨○○§▨
▨▨▨▨▨▨▨▨▨