▨▨▨▨▨▨▨▨▨
▨○Ⅲ☆○○○○▨
▨◎▨○▨▨▨○▨
▨★▨○▨V○○▨
▨○▨○▨▨V○▨
▨>§○○○◎▨▨
▨▨▨▨▨▨▨▨▨