▨▨▨▨▨▨▨▨▨
▨◎▨☆▨ § ▨▨▨
▨　▨　▨　▨▨▨
▨　▨　▨　　　▨
▨　▨　▨▨▨　▨
▨　Ⅲ　　　　♥▨
▨▨▨▨▨▨▨▨▨