▨▨▨▨▨▨▨▨▨▨▨▨▨▨▨▨
▨▨▨>○V○○○○V▨▨▨▨▨▨
▨▨▨○○○○○○○○▨▨▨▨▨
▨☆◎◎◎◎◎◎◎◎◎◎◎◎★▨
▨▨▨○○○○○○○○▨▨▨▨▨
▨▨▨>○V○○○○V▨▨▨▨▨
▨▨▨▨▨▨▨▨▨▨▨▨▨▨▨▨
