▨▨▨▨▨▨▨▨
▨§▨○▨★○▨
▨◎▨○▨○○▨
▨○○○Ⅲ○○▨
▨▨▨○▨▨▨▨
▨○◎○○○V▨
▨◎▨○▨▨▨▨
▨○▨○▨>§▨
▨◎▨○▨▨◎▨
>◎VⅢ○○☆▨
▨▨▨▨▨▨▨▨