▨▨▨▨▨▨▨▨▨▨▨▨▨
▨V▨○○○☆○○○▨V▨
▨○▨○○○○○○○▨○▨
▨◎>○○○○○○○▨○▨
▨○▨○○○○○○○▨○▨
▨○▨○○○○○○○○◐▨
▨○▨○○○○○○○▨○▨
▨○▨○○○○○○○○○▨
▨○>○○○○○○○▨○▨
▨○▨○○○○○○○○○▨
▨○▨○○○○○○○▨○▨
▨○>○○○○○○○○◎▨
▨○▨○○○○○○○▨○▨
▨○▨○○○○○○○○◎▨
▨○▨○○○○○○○▨○▨
▨○▨○○○★○○○○◎▨
▨▨▨▨▨▨▨▨▨▨▨▨▨▨