▨▨▨▨▨▨▨▨▨▨▨▨▨▨▨
▨▨▨▨▨▨○◎○▨▨▨▨▨▨
▨▨▨▨▨○○○○○▨▨▨▨▨
▨☆◎○○○○A○○○○○★▨
▨▨▨▨▨○○○○○▨▨▨▨▨
▨▨▨▨▨▨○◎○▨▨▨▨▨▨
▨▨▨▨▨▨▨▨▨▨▨▨▨▨▨
