▨▨▨▨▨▨▨▨▨
▨V▨☆○Ⅲ○★▨
▨○▨○○▨▨▨▨
▨○○○○○▨A▨
>○▨▨▨○▨○▨
▨○○§▨○○○▨
▨▨▨▨▨▨◎▨▨
▨○§▨○Ⅲ○◐▨
▨○▨▨○▨▨▨▨
▨○○○○V○○▨▨
▨○▨▨▨○▨▨
>◎○A▨>○○▨
▨▨▨▨▨▨▨▨▨