▨▨▨▨▨▨▨▨▨▨▨▨▨▨▨▨
▨▨▨▨A▨▨▨○○○○▨▨▨▨▨
▨▨▨A▨◎○○○○○▨▨▨▨▨
▨☆○○▨▨◎▨>V○○○◎★▨
▨▨○○○▨▨▨○○○▨▨▨▨▨
▨▨▨○○○○○○○○▨▨▨▨▨
▨▨▨▨▨▨▨▨▨▨▨▨▨▨▨▨
