▨▨▨▨▨▨▨▨▨▨▨▨▨▨▨▨
▨▨▨>○◎>◎○◎▨▨▨▨▨▨
▨▨▨▨▨○▨○▨○▨▨▨▨▨▨
▨☆◎○○※▨※▨※○○○○★▨
▨▨▨▨▨○▨○▨▨▨▨▨▨▨▨
▨▨▨>○◎○○▨▨▨▨▨▨▨
▨▨▨▨▨▨▨▨▨▨▨▨▨▨▨▨
