▨▨▨▨▨▨▨▨▨▨▨▨▨
▨V▨○○○☆○○○▨V▨
▨○▨▨▨▨▨▨▨○○○▨
▨◎>○○○○▨○○▨○▨
▨○○○▨▨▨○○○▨▨▨
▨○▨○▨○○○○○○○▨
▨▨▨○○▨○○▨▨▨▨▨
▨◐▨▨○▨▨○○○○○▨
▨○○○○○▨▨○▨▨○▨
▨○▨○▨○○▨○○▨○▨
▨○>○○○▨▨▨▨▨○▨
▨○○○▨○○○○○○◎▨
▨○▨▨○○▨○▨▨▨▨▨
▨○▨○○▨○○○○○V▨
▨○▨○▨▨○▨▨▨▨○▨
▨◎▨>○○★○○○○○▨
▨▨▨▨▨▨▨▨▨▨▨▨▨▨