▨▨▨▨▨▨▨▨
>☆◎○○○○▨
▨◎▨※A○○▨
▨○▨※▨○○▨
▨○▨※▨○▨▨
▨○▨※▨V★▨
▨○▨※▨○▨▨
▨V▨※▨○○▨
▨○A○▨○○▨
>○○○○○○▨
▨▨▨▨▨▨▨▨