▨▨▨▨▨▨▨▨▨▨▨▨▨▨▨▨
▨○○★>○◎V◎>○○○○◎▨
▨○▨▨▨▨○☆○○○▨▨▨▨▨
▨○※○○○○◐○○○○○○◎▨
▨▨▨▨▨▨◎▨▨▨▨▨▨▨▨▨
▨>○○○○○○○○○○○○A▨
▨▨▨▨▨▨▨▨▨▨▨▨▨▨▨▨
