▨▨▨▨▨▨▨▨▨▨▨▨▨▨▨▨
▨▨▨>○V>◎○○▨▨▨▨▨▨
▨▨▨▨▨○▨○○○▨▨▨▨▨▨
▨※◎○○○▨※▨◐○○○☆★▨
▨▨▨▨▨○▨○▨▨▨▨▨▨▨▨
▨▨▨>○◎○○▨▨▨▨▨▨▨
▨▨▨▨▨▨▨▨▨▨▨▨▨▨▨▨
