▨▨▨▨▨▨▨▨
>☆○○○○V▨
▨▨▨▨▨▨○▨
▨◎▨★▨V◎▨
▨○A○▨○○▨
▨○▨○▨○⇔▨
▨○▨○▨○▨▨
▨V▨○▨○○▨
▨○A○>○○▨
>○○○○○○▨
▨▨▨▨▨▨▨▨