▨▨▨▨▨▨▨▨
▨§▨◎▨★○▨
▨◎▨○▨○○▨
>○○○Ⅲ○○▨
▨▨▨※▨▨▨▨
>○◎○§○V▨
▨○▨○▨▨▨▨
▨○▨○▨○◎▨
▨○▨○▨○○▨
>○○○○☆▨
▨▨▨▨▨▨▨▨