▨▨▨▨▨▨▨▨▨▨▨▨▨▨▨▨▨▨
▨○○○○○○○○○○○○○○○○▨
▨○○○○○○○○○○○○○○▨○▨
▨○○○○○○○○○○○○○▨▨○▨
▨○○○○○○○○○○○▨○▨▨○▨
▨○○○○○○○○○○▨▨○▨▨○▨
▨○○○○○○○○▨○▨▨○▨▨○▨
▨○○○○◎◎○▨▨○▨▨○▨▨○▨
▨○○○○◎▨○▨▨○▨▨○▨▨○▨
▨○○○☆◎▨○▨▨○▨▨○▨▨○▨
▨▨▨▨▨▨▨◎▨▨◎▨▨◎▨▨★▨
▨▨▨▨▨▨▨▨▨▨▨▨▨▨▨▨▨▨