▨▨▨▨▨▨▨▨▨▨
▨>○○☆◎○○○▨
▨▨▨▨○▨▨▨▨▨
▨>○○○○◎○○▨
▨▨▨▨○▨▨▨▨▨
>★○○⇔○○◎○▨
▨▨▨▨○▨▨▨▨▨
▨>○○○○○○◎▨
▨▨▨▨○▨▨▨V▨
▨>○○○○○○◎▨
▨▨▨▨▨▨▨▨▨▨
