▨▨▨▨▨▨▨▨▨▨▨▨▨▨▨▨▨▨▨
▨○☆○▨◎○○○○○▨○○○○○◎▨
▨○○○▨◎○○○▨○※○▨○○○◎▨
▨○▨○▨◎○○○○○▨○○○○○◎▨
▨○○○▨◎○○○▨○※○▨○○○◎▨
▨○▨○▨◎○○○○○▨○○○○○◎▨
▨○§○▨◎○○○▨○※○▨○○○◎▨
▨○▨○▨◎○○○○○▨○○○○○◎▨
▨○○○▨◎○○○▨○※○▨○○○◎▨
▨○▨○▨◎○○○○○▨○○○○○◎▨
▨○★○Ⅲ○○○○○○○○○○○○○▨
▨▨▨▨▨▨▨▨▨▨▨▨▨▨▨▨▨▨▨
