▨▨▨▨▨▨▨▨▨▨▨▨▨▨▨▨
▨▨▨>○◎▨◎○◎▨▨▨▨▨▨
▨▨▨▨▨○▨○▨○▨▨▨▨▨▨
▨☆◎○○○▨○▨○○○○○★▨
▨▨▨▨▨○▨○▨○▨▨▨▨▨▨
▨▨▨▨▨◎○◎▨◎▨▨▨▨▨▨
▨▨▨▨▨▨▨▨▨▨▨▨▨▨▨▨
