▨▨▨▨▨▨▨▨▨▨▨▨▨▨▨▨▨▨▨▨▨▨
▨A○○○>○○○○♥○>○○○○○○○◐▨
▨▨▨○▨▨▨▨▨▨▨○○○○○○○○○○▨
▨○▨○▨▨▨▨▨▨▨▨▨▨▨▨▨○⇔○○▨
▨V○○▨◎○○○○○♥○○○◎▨○○○○▨
▨§V○▨○○>○○○○>○○○▨▨▨▨○▨
▨▨○▨▨○○○○○○○○○○▨○○○○○▨
▨○○○▨○○○○○○○○○○▨>○○○○▨
▨○○V▨○○○○○○○○○○▨○○○○○▨
▨▨▨○▨○○○○○★○○○○▨○○○○○▨
▨☆○○▨◎○○○○○○○○○○○○○○○▨
▨▨▨▨▨▨▨▨▨▨▨▨▨▨▨▨▨▨▨▨▨▨
