▨▨▨▨▨▨▨▨▨▨▨▨▨▨▨▨
▨▨▨V○◎>◎○◎▨▨▨▨▨▨
▨▨▨▨▨○▨○▨○▨▨▨▨▨▨
▨☆◎○○※A※A※○○○○★▨
▨▨▨▨▨○▨○▨▨▨▨▨▨▨▨
▨▨▨V○◎○○▨▨▨▨▨▨▨
▨▨▨▨▨▨▨▨▨▨▨▨▨▨▨▨
