▨▨▨▨▨▨▨▨▨
▨◎◎☆○Ⅲ★○▨
▨◎○◎○▨▨▨▨
▨◎○◎◎◎◎◎▨
▨◎§◎▨○○○▨
▨◎◎◎▨○○○▨
▨▨▨▨▨▨▨▨▨