▨▨▨▨▨▨▨▨▨▨▨▨▨▨▨
▨▨▨▨▨A○◎○A▨▨▨▨▨
▨▨▨▨▨○○○○○▨▨▨▨▨
▨☆◎○○○○V○○○○○★▨
▨▨▨▨▨○○○○○▨▨▨▨▨
▨▨▨▨▨A○◎○A▨▨▨▨▨
▨▨▨▨▨▨▨▨▨▨▨▨▨▨▨
