▨▨▨▨▨▨▨▨▨▨▨▨▨
▨V▨○○○☆○○○▨V▨
▨○▨⇔○○★○○○▨○▨
▨◎>○○○○○○○▨§▨
▨○▨○○○○○○○▨○▨
▨○Ⅲ○○○○○○○○○▨
▨▨▨▨▨▨▨▨▨▨▨▨▨▨