▨▨▨▨▨▨▨▨▨▨▨▨
▨☆○◎○○○○○○○▨
▨○○◎○○○○○○○▨
▨○○◎○○○○○○○▨
▨○◎◎○○○○○○○▨
▨○◎○○○○○○○○▨
▨◎○○○○○○○○○▨
▨◎○○○○○○○○○▨
▨◎◎◎◎◎◎◎◎◎★▨
▨▨▨▨▨▨▨▨▨▨▨▨
