▨▨▨▨▨▨▨▨▨▨▨▨▨▨▨▨
▨▨▨>○◎○○○○◎▨▨▨▨▨
▨▨▨○○○○○○○○▨▨▨▨▨
▨☆◎◎◎◎◎◎◎V◎◎◎◎★▨
▨▨▨○○○○○○○○▨▨▨▨
▨▨▨>○◎○○○○◎▨▨▨▨▨
▨▨▨▨▨▨▨▨▨▨▨▨▨▨▨▨
