▨▨▨▨▨▨▨▨▨▨▨▨▨
▨☆○○○○○○○○○○▨
▨★○○>○○○○○○○▨
▨○○○▨○○○○◎○○▨
▨○○○▨○○○○○○○▨
▨○○○▨○○○○○○○▨
▨○○○▨○○○○▨▨▨▨
▨▨▨▨▨○○○○○○○▨
▨○○◎Ⅲ○○▨○○○○▨
▨○○○▨○○▨○○○○▨
▨○○○▨○○▨○○○○▨
▨○○○>○○▨○○○◎▨
▨○○○▨○○▨○▨▨▨▨
▨○○♥▨○○○○○○V▨
▨○▨▨▨○○○○○V○▨
▨○○○⇔○○○○V○§▨
▨▨▨▨▨▨▨▨▨▨▨▨